11111111111111111111111111111111111111111111111111111111111111111111111111111111
11111111111111111111111111111111111111111111111111111111111111111111111111111111
11100000000000000000000000000000000000000000000000000000000000000000000000000111
11100000000000000000000000000000000000000000000000000000000000000000000000000111
11100000000000000000000000000000000000000000000000000000000000000000000000000111
11111111111111111111111111111111111111111111111111111111111111111111111110000111
11111111111111111111111111111111111111111111111111111111111111111111111110000111
11111111111111111111111111111111111111111111111111111111111111111111111110000111
11100000000000000000000000000000000000000000000000000000000000000000001110000111
11100000000000000000000000000000000000000000000000000000000000000000001110000111
11100000000000000000000000000000000000000000000000000000000000000000001110000111
11100000000000000000000000000000000000000000000000000000000000000000001110000111
11100001111111111111111111111111111111111111111111111111111111111100001110000111
11100001111111111111111111111111111111111111111111111111111111111100001110000111
11100001111111111111111111111111111111111111111111111111111111111100001110000111
11100001110000000000000000000000000000000000000000000000000000011100001110000111
11100001110000000000000000000000000000000000000000000000000000011100001110000111
11100001110000000000000000000000000000000000000000000000000000011100001110000111
11100001110000000000000000000000000000000000000000000000000000011100001110000111
11100001110000111111111111111111111111111111111111111111111000011100001110000111
11100001110000111111111111111111111111111111111111111111111111111100001110000111
11100001110000111111111111111111111111111111111111111111111111111100001110000111
11100001110000111111111111111111111111111111111111111111111111111100001110000111
11100001110000000000000000000000000000000000000000000000000000000000001110000111
11100001110000000000000000000000000000000000000000000000000000000000001110000111
11100001110000000000000000000000000000000000000000000000000000000000001110000111
11100001111111111111111111111111111111111111111111111111111111111111111110000111
11100001111111111111111111111111111111111111111111111111111111111111111110000111
11100001111111111111111111111111111111111111111111111111111111111111111110000111
11100000000000000000000000000000000000000000000000000000000000000000000000000111
11100000000000000000000000000000000000000000000000000000000000000000000000000111
11100000000000000000000000000000000000000000000000000000000000000000000000000111
11100000000000000000000000000000000000000000000000000000000000000000000000000111
11111111111111111111111111111111111111111111111111111111111111111111111111111111
11111111111111111111111111111111111111111111111111111111111111111111111111111111
=
V 100 100
F 1888 608
F 1920 608
F 1952 608
F 1984 608