................................................................................
................................................................................
.....                                                    #           ...........
.....      S                                                           .........
.....                                                    #              ........
............................................................           .........
