11111111111111111111111111111111111111111111111111111111111111111111111111111111
11111111111111111111111111111111111111111111111111111111111111111111111111111111
11111000000000000000000000000000000000011111111110000000000000000000011111111111
11111000000000001111111110000000000000111111111100000000000000000000111111111111
11111000000000011111111110000000000000000000000000000000000000000000111111111111
11111111111111111111111111111111111111111111111111111111111100000000000111111111
11111111111111111111111111111111111111111111111111111111111110000000000111111111
22222222222222222222222222222222222222222222222222222221111111100000000001111111
11111111111111111111111111121111111111111111111111111111111111100000000001111111
11111111111111111111111111121111111111111111111111111111111110000000000111111111
11111111111111111111111111121111111111111111111111100000000000000000000111111111
11111111111110011111111111121111111111111111111000000000000000000000000000011111
11111111111110111111111111121111111111111111111100000000000000000000000000011111
11111111111111111111111111121111111111111111100000000000000000000000001111111111
11111111111111111111111111121111111111111110000000000222222222222222222222222222
00000000000001111111111111121111111111111110000000000222222222222222222222222222
00000000000001111111111111121111111111111111110000000000000000000000000000000000
00000000000001111111111111121111111111111111111111110000000000000000000000000000
00000000000001111111111111122222222222222222222222222222222222222222200000000000
00000000000001111111111111122222222222222222222222222222222222222222200000000000
00000000000001111111111111121111111000000000000000000000000000000000000000001111
00000000000000001111111111111111000000000000000000000000000000000000000011111111
00000000000000000001111111110000000000000000000000000000000011111111111111111111
00000000000000000000000000000000000000000000000000001111111111111111111111111111
00000000000000000000000000000000000000000000000000011111111111111111111111111111
00000000000000000000000000000000000000000011111111111111111111111111111111111111
00000000000000000000000000000000000011111111111111111111111111111111111111111111
11111111111111111111111111111111111111111111111111111111111111111111111111111111
11111111111111111111111111111111111111111111111111111111111111111111111111111111
11111111111111111111111111111111111111111111111111111111111111111111111111111111
11111111111111111111111111111111111111111111111111111111111111111111111111111111
11111111111111111111111111111111111111111111111111111111111111111111111111111111