111222222222222222222222222222222111
100211222222222222222222222222222001
100211222222222222222222112222222001
100211222222222222222222112222222001
100211222222221122222222112222222001
100211222222222222222222112222222001
100211222222221122222222222222222001
100211222222221122222222112222222001
100211222222222222222222112222222001
100211222222221122222222112222222001
100222222222221122222222222222222001
100211222222221122222222112222222001
100211222222221122222222112222222001
100211222222221122222222112222222001
100211222222221122222222112222222001
100211222222222222222222112222222001
100211222222222222222222112222222001
100211222222221122222222112222222001
100211222222221122222222112222222001
100211222222221122222222112222222001
100211222222221122222222112222222001
100211222222221122222222112222222001
100211222222221122222222112222222001
111222222222222222222222222222222111
=
F 1080 100
F 1080 132
F 1080 164
V 100 100
