111222222222222222222222222222222111
100211222222222222222222222222222001
100211222222222222222222112222222001
100211222222222222222222112222222001
100211222222221122222222112222222001
100211222222222222222222112222222001
111200222222221122222222222222222001
111200222222221122222222112222222001
111211222222222222222222002222222001
111211222222221122222222112222222001
111222222222221122222222222222222001
111211222222220022222222112222222001
111211222222221122222222112222222001
111211222222220022222222002222222001
111211222222220022222222002222222001
111211222222222222222222002222222001
111211222222222222222222002222222001
111211222222221122222222112222222001
111211222222221122222222112222222001
111211222222220022222222002222222001
111211222222220022222222002222222001
111211222222220022222222002222222001
111211222222221122222222112222222001
111222222222222222222222222222222111
=
F 1080 100
F 1080 132
F 1080 164
V 50 100
R 250 100
R 250 140
R 250 180
R 250 220
R 250 260
R 250 300
R 600 250
R 600 290
R 600 330
R 600 370
R 600 410
R 600 450
R 950 100
R 950 140
R 950 180
R 950 220
R 950 260
R 950 300
R 950 340
R 950 380
R 950 420
R 950 460
R 950 500
R 950 540
R 950 580
T 43 200
T 43 250
T 43 300
T 43 350
T 43 400
T 43 450
T 43 500
T 43 550
T 43 600
T 43 650
T 43 700
T 140 500
T 140 650
T 465 205
L 300 500
L 900 500
L 600 100
L 400 300
