111111111111111111111111111111111111111111
100001111111000000000000000000000011111111
100001111110000000000000000000000000011111
100001111102000000000000000000000020001111
100000000002200111111111111111112221001111
111111000000001111000000000001122111001111
111111000000011110000000000000221111001111
111111000000011110001111111002211000001111
111111000000111110001111111222110000001111
111111000000111110001112222220000011111111
111111000000111110001222221110000011111111
111111000000111110001222111111111111111111
111111000000111110002211000000001111111111
111111000000111110002200000000000011111111
111111000000111110002200011000000001111111
111111000000111110002200011111100001111111
111111000000111110002200011111100001111111
111111000000111110002200011111110000111111
111111000000111110002200011111110000111111
111111000000111110002200011111110000111111
111111000000111110002200011111110000111111
111111000000111111002201111111110000111111
111111000000111111112211111111110000111111
111111000000111111112211111111110000111111
=
R 498 116
R 498 148
R 466 180
R 466 212
R 466 244
R 434 276
R 434 308
R 434 340
R 434 372
R 434 404
R 434 436
R 434 468
R 434 500
R 434 532
R 434 564
R 466 596
R 466 628
R 466 660
R 498 692
R 498 724
R 838 340
R 870 340
R 902 340
R 936 340
R 968 340
R 1000 340
R 1032 340
R 1064 340
R 1096 340
R 1128 340
R 1160 340
R 1192 308
R 1224 276
R 1246 244
R 1268 212
R 530 116
R 562 116
R 596 116
R 628 116
R 660 116
R 692 116
R 724 116
R 756 116
R 788 116
R 820 116
R 852 116
R 884 116
R 916 116
R 948 132
R 980 148
R 1286 180
F 1026 720
F 1058 720
F 1090 720
F 1122 720
T 80 192
T 80 256
T 80 320
T 80 384
T 80 448
T 80 512
T 80 576
T 80 640
T 80 704
T 176 76
T 240 76
T 692 248
T 838 512
T 936 512
T 838 576
T 936 576
T 838 640
T 936 640
T 838 704
T 936 704
V 64 96