,............................................................................
. S   ......                                                        .........
.    ......                                                            ......
.    .....                                                             ......
.              .....................................           ..............
......        ...........................................           .........
......       ...........................................            .........
......       ...........................................            .........
......      ...........................................   #      #...........
